--------------------------------###-----
----########------------------#----#----
-------##---------------------#---#-----
-------##----------------------##---#---
--#----##--------------------#---#-#----
---#---##------------------#------#-----
----#####------------------#-----#--#---
---######--------------------#-------#--
--------------------#######-------------
--------------------##-----#------------
--------------------##----#-------------
--------------------#####---------------
--------------------##---#--------------
--------------------##----#-------------
--------------------##-----#------------

