#-------#---#---#-------#--#---#---#---#
#-------#-------#-------#------#-------#
#-------#-------#-------#------#-------#
#-------#-------#-------#------#-------#
#-------#-------#-------#------#-------#
#-------#-------#-------#------#-------#
#-------#-------#-------#------#-------#
#-------#-------#-------#------#-------#
#-------#-------#-T-----#------#-------#
#-------#-------#-------#------#-------#
#-------#-------#-------#------#-------#
#-------#-------#-------#------#-------#
#-------#-------#-------#------#-------#
#-------#-------#-------#------#-------#
#---#---#-------#---#---#--#---#---#---#