----------------------------------------
####------------------#-----------------
----------------------#-----------------
----------------------####--------------
----------------------------------#----#
---------------------------#------#-----
--------##########----------------#-----
----------------------------------#-----
------------------T---------------------
----------------------------------------
---------###----------------------------
-----------#---------------####---------
-----------#----------------------------
-----------#----------------------------
---------------------------------------#