-------------------------------#--------
####------------------#--------#--------
#---------------------#--------#--------
#---------------------#--------#########
#--------------------------------------#
######---------------------#------------
-----#--##########----------------------
----------########--T-------------------
----------------------------------------
---------------------------####---------
---------###---------------#--#---------
-----------#---------------####---------
-----------#----------------------------
-----------#--------#######-#-----------
---------------------------------------#